{
	"array":
	[
		{
			"id": "battlePlacement_standart",

			"variants":
			[
				{
					"left":
					[
						 1,1,0,0,0,0,0,0,0,0,0,0,0,
						1,1,0,0,0,0,0,0,0,0,0,0,0,
						 1,1,0,0,0,0,0,0,0,0,0,0,0,
						1,1,0,0,0,0,0,0,0,0,0,0,0,
						 1,1,0,0,0,0,0,0,0,0,0,0,0,
						1,1,0,0,0,0,0,0,0,0,0,0,0,
						 1,1,0,0,0,0,0,0,0,0,0,0,0,
						1,1,0,0,0,0,0,0,0,0,0,0,0,
						 1,1,0,0,0,0,0,0,0,0,0,0,0,
						1,1,0,0,0,0,0,0,0,0,0,0,0,
						 1,1,0,0,0,0,0,0,0,0,0,0,0
					],
					"right":
					[
						 0,0,0,0,0,0,0,0,0,0,1,1,0,
						0,0,0,0,0,0,0,0,0,0,0,1,1,
						 0,0,0,0,0,0,0,0,0,0,1,1,0,
						0,0,0,0,0,0,0,0,0,0,0,1,1,
						 0,0,0,0,0,0,0,0,0,0,1,1,0,
						0,0,0,0,0,0,0,0,0,0,0,1,1,
						 0,0,0,0,0,0,0,0,0,0,1,1,0,
						0,0,0,0,0,0,0,0,0,0,0,1,1,
						 0,0,0,0,0,0,0,0,0,0,1,1,0,
						0,0,0,0,0,0,0,0,0,0,0,1,1,
						 0,0,0,0,0,0,0,0,0,0,1,1,0
					]
				},
				{
					"left":
					[
						 1,1,0,0,0,0,0,0,0,0,0,0,0,
						1,1,0,0,0,0,0,0,0,0,0,0,0,
						 1,1,0,0,0,0,0,0,0,0,0,0,0,
						1,1,0,0,0,0,0,0,0,0,0,0,0,
						 1,1,0,0,0,0,0,0,0,0,0,0,0,
						1,1,0,0,0,0,0,0,0,0,0,0,0,
						 1,1,0,0,0,0,0,0,0,0,0,0,0,
						1,1,0,0,0,0,0,0,0,0,0,0,0,
						 1,1,0,0,0,0,0,0,0,0,0,0,0,
						1,1,0,0,0,0,0,0,0,0,0,0,0,
						 1,1,0,0,0,0,0,0,0,0,0,0,0
					],
					"right":
					[
						 0,0,0,0,0,0,0,0,0,0,1,1,0,
						0,0,0,0,0,0,0,0,0,0,0,1,1,
						 0,0,0,0,0,0,0,0,0,0,1,1,0,
						0,0,0,0,0,0,0,0,0,0,0,1,1,
						 0,0,0,0,0,0,0,0,0,0,1,1,0,
						0,0,0,0,0,0,0,0,0,0,0,1,1,
						 0,0,0,0,0,0,0,0,0,0,1,1,0,
						0,0,0,0,0,0,0,0,0,0,0,1,1,
						 0,0,0,0,0,0,0,0,0,0,1,1,0,
						0,0,0,0,0,0,0,0,0,0,0,1,1,
						 0,0,0,0,0,0,0,0,0,0,1,1,0
					]
				},
				{
					"left":
					[
						 1,1,0,0,0,0,0,0,0,0,0,0,0,
						1,1,0,0,0,0,0,0,0,0,0,0,0,
						 1,1,0,0,0,0,0,0,0,0,0,0,0,
						1,1,0,0,0,0,0,0,0,0,0,0,0,
						 1,1,0,0,0,0,0,0,0,0,0,0,0,
						1,1,0,0,0,0,0,0,0,0,0,0,0,
						 1,1,0,0,0,0,0,0,0,0,0,0,0,
						1,1,0,0,0,0,0,0,0,0,0,0,0,
						 1,1,0,0,0,0,0,0,0,0,0,0,0,
						1,1,0,0,0,0,0,0,0,0,0,0,0,
						 1,1,0,0,0,0,0,0,0,0,0,0,0
					],
					"right":
					[
						 0,0,0,0,0,0,0,0,0,0,1,1,0,
						0,0,0,0,0,0,0,0,0,0,0,1,1,
						 0,0,0,0,0,0,0,0,0,0,1,1,0,
						0,0,0,0,0,0,0,0,0,0,0,1,1,
						 0,0,0,0,0,0,0,0,0,0,1,1,0,
						0,0,0,0,0,0,0,0,0,0,0,1,1,
						 0,0,0,0,0,0,0,0,0,0,1,1,0,
						0,0,0,0,0,0,0,0,0,0,0,1,1,
						 0,0,0,0,0,0,0,0,0,0,1,1,0,
						0,0,0,0,0,0,0,0,0,0,0,1,1,
						 0,0,0,0,0,0,0,0,0,0,1,1,0
					]
				},

				{
					"left":
					[
						 1,1,0,0,0,0,0,0,0,0,0,0,0,
						1,1,0,0,0,0,0,0,0,0,0,0,0,
						 1,1,0,0,0,0,0,0,0,0,0,0,0,
						1,1,0,0,0,0,0,0,0,0,0,0,0,
						 1,1,0,0,0,0,0,0,0,0,0,0,0,
						1,1,0,0,0,0,0,0,0,0,0,0,0,
						 1,1,0,0,0,0,0,0,0,0,0,0,0,
						1,1,0,0,0,0,0,0,0,0,0,0,0,
						 1,1,0,0,0,0,0,0,0,0,0,0,0,
						1,1,0,0,0,0,0,0,0,0,0,0,0,
						 1,1,0,0,0,0,0,0,0,0,0,0,0
					],
					"right":
					[
						 0,0,0,0,0,0,0,0,0,0,1,1,0,
						0,0,0,0,0,0,0,0,0,0,0,1,1,
						 0,0,0,0,0,0,0,0,0,0,1,1,0,
						0,0,0,0,0,0,0,0,0,0,0,1,1,
						 0,0,0,0,0,0,0,0,0,0,1,1,0,
						0,0,0,0,0,0,0,0,0,0,0,1,1,
						 0,0,0,0,0,0,0,0,0,0,1,1,0,
						0,0,0,0,0,0,0,0,0,0,0,1,1,
						 0,0,0,0,0,0,0,0,0,0,1,1,0,
						0,0,0,0,0,0,0,0,0,0,0,1,1,
						 0,0,0,0,0,0,0,0,0,0,1,1,0
					]
				},
				{
					"left":
					[
						 1,1,1,0,0,0,0,0,0,0,0,0,0,
						1,1,1,0,0,0,0,0,0,0,0,0,0,
						 1,1,1,0,0,0,0,0,0,0,0,0,0,
						1,1,1,0,0,0,0,0,0,0,0,0,0,
						 1,1,1,0,0,0,0,0,0,0,0,0,0,
						1,1,1,0,0,0,0,0,0,0,0,0,0,
						 1,1,1,0,0,0,0,0,0,0,0,0,0,
						1,1,1,0,0,0,0,0,0,0,0,0,0,
						 1,1,1,0,0,0,0,0,0,0,0,0,0,
						1,1,1,0,0,0,0,0,0,0,0,0,0,
						 1,1,1,0,0,0,0,0,0,0,0,0,0
					],
					"right":
					[
						 0,0,0,0,0,0,0,0,0,1,1,1,0,
						0,0,0,0,0,0,0,0,0,0,1,1,1,
						 0,0,0,0,0,0,0,0,0,1,1,1,0,
						0,0,0,0,0,0,0,0,0,0,1,1,1,
						 0,0,0,0,0,0,0,0,0,1,1,1,0,
						0,0,0,0,0,0,0,0,0,0,1,1,1,
						 0,0,0,0,0,0,0,0,0,1,1,1,0,
						0,0,0,0,0,0,0,0,0,0,1,1,1,
						 0,0,0,0,0,0,0,0,0,1,1,1,0,
						0,0,0,0,0,0,0,0,0,0,1,1,1,
						 0,0,0,0,0,0,0,0,0,1,1,1,0
					]
				},
				{
					"left":
					[
						 1,1,1,1,0,0,0,0,0,0,0,0,0,
						1,1,1,1,0,0,0,0,0,0,0,0,0,
						 1,1,1,1,0,0,0,0,0,0,0,0,0,
						1,1,1,1,0,0,0,0,0,0,0,0,0,
						 1,1,1,1,0,0,0,0,0,0,0,0,0,
						1,1,1,1,0,0,0,0,0,0,0,0,0,
						 1,1,1,1,0,0,0,0,0,0,0,0,0,
						1,1,1,1,0,0,0,0,0,0,0,0,0,
						 1,1,1,1,0,0,0,0,0,0,0,0,0,
						1,1,1,1,0,0,0,0,0,0,0,0,0,
						 1,1,1,1,0,0,0,0,0,0,0,0,0
					],
					"right":
					[
						 0,0,0,0,0,0,0,0,1,1,1,1,0,
						0,0,0,0,0,0,0,0,0,1,1,1,1,
						 0,0,0,0,0,0,0,0,1,1,1,1,0,
						0,0,0,0,0,0,0,0,0,1,1,1,1,
						 0,0,0,0,0,0,0,0,1,1,1,1,0,
						0,0,0,0,0,0,0,0,0,1,1,1,1,
						 0,0,0,0,0,0,0,0,1,1,1,1,0,
						0,0,0,0,0,0,0,0,0,1,1,1,1,
						 0,0,0,0,0,0,0,0,1,1,1,1,0,
						0,0,0,0,0,0,0,0,0,1,1,1,1,
						 0,0,0,0,0,0,0,0,1,1,1,1,0
					]
				},
				{
					"left":
					[
						 1,1,1,1,1,0,0,0,0,0,0,0,0,
						1,1,1,1,1,0,0,0,0,0,0,0,0,
						 1,1,1,1,1,0,0,0,0,0,0,0,0,
						1,1,1,1,1,0,0,0,0,0,0,0,0,
						 1,1,1,1,1,0,0,0,0,0,0,0,0,
						1,1,1,1,1,0,0,0,0,0,0,0,0,
						 1,1,1,1,1,0,0,0,0,0,0,0,0,
						1,1,1,1,1,0,0,0,0,0,0,0,0,
						 1,1,1,1,1,0,0,0,0,0,0,0,0,
						1,1,1,1,1,0,0,0,0,0,0,0,0,
						 1,1,1,1,1,0,0,0,0,0,0,0,0
					],
					"right":
					[
						 0,0,0,0,0,0,0,1,1,1,1,1,0,
						0,0,0,0,0,0,0,0,1,1,1,1,1,
						 0,0,0,0,0,0,0,1,1,1,1,1,0,
						0,0,0,0,0,0,0,0,1,1,1,1,1,
						 0,0,0,0,0,0,0,1,1,1,1,1,0,
						0,0,0,0,0,0,0,0,1,1,1,1,1,
						 0,0,0,0,0,0,0,1,1,1,1,1,0,
						0,0,0,0,0,0,0,0,1,1,1,1,1,
						 0,0,0,0,0,0,0,1,1,1,1,1,0,
						0,0,0,0,0,0,0,0,1,1,1,1,1,
						 0,0,0,0,0,0,0,1,1,1,1,1,0
					]
				},
				{
					"left":
					[
						 1,1,1,1,1,1,0,0,0,0,0,0,0,
						1,1,1,1,1,1,0,0,0,0,0,0,0,
						 1,1,1,1,1,1,0,0,0,0,0,0,0,
						1,1,1,1,1,1,0,0,0,0,0,0,0,
						 1,1,1,1,1,1,0,0,0,0,0,0,0,
						1,1,1,1,1,1,0,0,0,0,0,0,0,
						 1,1,1,1,1,1,0,0,0,0,0,0,0,
						1,1,1,1,1,1,0,0,0,0,0,0,0,
						 1,1,1,1,1,1,0,0,0,0,0,0,0,
						1,1,1,1,1,1,0,0,0,0,0,0,0,
						 1,1,1,1,1,1,0,0,0,0,0,0,0
					],
					"right":
					[
						 0,0,0,0,0,0,1,1,1,1,1,1,0,
						0,0,0,0,0,0,0,1,1,1,1,1,1,
						 0,0,0,0,0,0,1,1,1,1,1,1,0,
						0,0,0,0,0,0,0,1,1,1,1,1,1,
						 0,0,0,0,0,0,1,1,1,1,1,1,0,
						0,0,0,0,0,0,0,1,1,1,1,1,1,
						 0,0,0,0,0,0,1,1,1,1,1,1,0,
						0,0,0,0,0,0,0,1,1,1,1,1,1,
						 0,0,0,0,0,0,1,1,1,1,1,1,0,
						0,0,0,0,0,0,0,1,1,1,1,1,1,
						 0,0,0,0,0,0,1,1,1,1,1,1,0
					]
				},
				{
					"left":
					[
						 1,1,1,1,1,1,1,0,0,0,0,0,0,
						1,1,1,1,1,1,1,0,0,0,0,0,0,
						 1,1,1,1,1,1,1,0,0,0,0,0,0,
						1,1,1,1,1,1,1,0,0,0,0,0,0,
						 1,1,1,1,1,1,1,0,0,0,0,0,0,
						1,1,1,1,1,1,1,0,0,0,0,0,0,
						 1,1,1,1,1,1,1,0,0,0,0,0,0,
						1,1,1,1,1,1,1,0,0,0,0,0,0,
						 1,1,1,1,1,1,1,0,0,0,0,0,0,
						1,1,1,1,1,1,1,0,0,0,0,0,0,
						 1,1,1,1,1,1,1,0,0,0,0,0,0
					],
					"right":
					[
						 0,0,0,0,0,1,1,1,1,1,1,1,0,
						0,0,0,0,0,0,1,1,1,1,1,1,1,
						 0,0,0,0,0,1,1,1,1,1,1,1,0,
						0,0,0,0,0,0,1,1,1,1,1,1,1,
						 0,0,0,0,0,1,1,1,1,1,1,1,0,
						0,0,0,0,0,0,1,1,1,1,1,1,1,
						 0,0,0,0,0,1,1,1,1,1,1,1,0,
						0,0,0,0,0,0,1,1,1,1,1,1,1,
						 0,0,0,0,0,1,1,1,1,1,1,1,0,
						0,0,0,0,0,0,1,1,1,1,1,1,1,
						 0,0,0,0,0,1,1,1,1,1,1,1,0
					]
				}
			]
		}
	]
}